07 07 07 07 07 07 07 07 07 07 07 07 07 07 07 07 07 07 07 07 07 07 07 07 07 07 07 07 07 07 07 07 07 07 07 07 07 07 07 07 07 07 07 07 07 07 07 07 07 07 07 07 07 07 07 07 07 07 07 07 07 07 07 07 07 07 07 07 07 07 07 07 07 07 07 07 07 07 07 07 07 07 07 07 07 07 07 07 07 07 07 07 07 07 07 07 07 07 07 07 07 07 07 07 07 07 07 07 07 07 07 07 07 07 07 07 07 07 07 07 07 07 07 07 07 07 07 07 07 07 07 07 07 07 07 07 07 07 07 07 07 07 07 07 07 07 07 07 07 07 07 07 07 07 07 07 07 07 07 07 07 07 07 07 07 07 07 07 07 07 07 07 07 07 07 07 07 07 07 07 07 07 07 07 07 07 07 07 07 07 07 07 07 07 07 07 07 07 07 07 07 07 07 07 07 07 07 07 07 07 07 07 07 07 07 07 07 07 07 07 07 07 07 07
07 07 07 07 07 07 06 06 06 06 06 06 07 07 07 07 06 06 06 06 07 07 07 07 07 06 07 07 07 07 07 06 06 06 06 06 07 07 07 07 06 06 06 06 07 07 07 07 06 06 06 06 06 06 07 07 07 06 06 06 06 06 06 06 07 07 07 07 06 06 06 06 06 06 07 07 07 07 07 06 06 06 06 06 06 06 06 07 07 07 07 06 06 07 07 07 06 06 06 06 06 06 07 07 07 07 06 06 06 06 06 06 06 06 07 07 07 07 06 06 06 06 06 06 06 07 07 06 06 07 07 07 07 06 06 06 06 06 07 07 07 06 06 06 06 06 06 07 07 07 06 06 06 06 06 06 06 07 07 07 06 06 06 06 06 06 06 07 07 07 07 06 06 06 06 06 06 06 06 07 07 07 07 07 07 07 06 07 07 07 07 07 06 06 06 06 06 06 06 06 07 07 07 06 06 06 06 06 06 07 07 07 06 06 06 06 06 06 06 07 07 07 07 07
07 06 06 07 07 07 06 03 03 03 03 03 06 07 07 06 03 03 03 03 03 06 07 07 06 03 03 06 07 07 06 03 03 03 03 03 06 07 07 06 03 03 03 03 06 07 07 06 03 03 03 03 03 03 06 07 07 06 03 03 03 03 03 03 06 07 07 06 03 03 03 03 03 03 06 07 07 07 06 03 03 03 03 03 03 03 03 06 07 07 06 03 03 06 07 06 03 03 03 03 03 03 06 07 07 06 03 03 03 03 03 03 03 03 06 07 07 06 03 03 03 03 03 03 06 07 06 03 03 06 07 07 06 03 03 03 03 03 06 07 07 06 03 03 03 03 03 06 07 07 06 03 03 03 03 03 03 06 07 06 03 03 03 03 03 03 03 03 06 07 06 03 03 03 03 03 03 03 03 06 07 06 06 07 07 06 03 06 07 07 07 06 03 03 03 03 03 03 03 06 07 07 07 06 03 03 03 03 03 06 07 06 03 03 03 03 03 03 03 06 07 07 06 07
07 03 03 06 07 06 03 03 03 03 03 06 07 07 06 03 03 03 03 03 03 03 06 07 06 03 03 03 06 07 06 03 03 03 03 03 03 06 07 06 03 03 03 03 03 06 07 06 03 03 03 03 03 03 03 06 07 03 03 03 03 03 03 03 03 06 07 06 03 03 03 03 03 03 03 06 07 07 06 03 03 03 03 03 03 03 03 03 06 07 03 03 03 03 06 03 03 03 03 03 03 03 03 06 07 06 03 03 03 03 03 03 03 03 03 06 07 06 03 03 03 03 03 03 06 07 06 03 03 03 06 07 06 03 03 03 03 03 03 06 07 06 03 03 03 03 03 03 06 07 06 03 03 03 03 03 03 03 06 03 03 03 03 03 03 03 03 03 03 06 03 03 03 03 03 03 03 03 06 07 06 03 03 06 07 03 03 03 03 03 07 06 03 03 03 03 03 03 03 03 06 07 06 03 03 03 03 03 03 03 07 06 03 03 03 03 03 03 06 07 07 06 03 07
07 03 03 03 06 03 03 03 03 03 03 03 06 03 03 03 03 03 03 03 03 03 03 06 03 03 03 03 03 06 03 03 03 03 03 03 03 03 06 03 03 03 03 03 03 03 06 03 03 03 03 03 03 03 03 03 06 03 03 03 03 03 03 03 03 03 06 03 03 03 03 03 03 03 03 03 06 07 03 03 03 03 03 03 03 03 03 03 03 06 03 03 03 03 03 06 03 03 03 03 03 03 03 03 06 03 03 03 03 03 03 03 03 03 03 03 06 07 03 03 03 03 03 03 03 06 03 03 03 03 03 06 03 03 03 03 03 03 03 03 06 03 03 03 03 03 03 03 03 06 03 03 03 03 03 03 03 03 06 03 03 03 03 03 03 03 03 03 03 03 03 03 03 03 03 03 06 06 03 03 03 03 03 03 06 03 03 03 03 03 06 03 03 03 03 03 03 03 03 03 03 06 03 03 03 03 03 03 03 03 06 03 03 03 03 03 03 03 03 06 06 06 03 07
07 03 03 03 03 03 03 03 03 03 03 06 03 03 03 03 03 03 03 03 03 03 03 03 03 03 03 03 03 03 03 03 03 03 03 03 03 03 03 03 03 03 03 03 03 03 03 03 03 03 03 03 03 03 03 03 03 03 03 03 03 03 03 03 03 03 03 03 03 03 03 03 03 03 03 03 03 06 03 03 03 03 03 03 03 03 03 03 03 03 03 03 03 03 03 03 03 03 03 03 03 03 03 03 03 03 03 03 03 03 03 03 03 03 03 03 03 06 06 03 03 03 03 03 06 03 03 03 03 03 03 03 03 03 03 03 03 03 03 03 03 03 03 03 03 03 03 03 03 03 03 03 03 03 03 03 03 03 03 03 03 03 03 03 03 03 03 03 03 03 03 03 03 03 03 03 03 03 03 03 03 03 03 03 03 03 03 03 03 03 03 03 03 03 03 03 03 03 03 03 03 03 03 03 03 03 03 03 03 03 03 03 03 03 03 03 03 06 06 03 03 03 03 07
07 03 03 03 03 03 03 03 03 03 03 03 03 03 03 03 03 06 03 03 03 03 03 03 03 03 03 03 03 03 03 03 03 03 03 03 03 03 03 03 03 03 03 03 03 03 03 03 03 03 03 03 03 03 03 03 03 03 03 03 03 03 03 03 03 03 03 03 03 03 03 03 03 03 03 03 03 03 03 03 03 03 03 03 03 03 03 03 03 03 03 03 03 03 03 03 03 03 03 03 03 03 03 03 03 03 03 03 03 03 03 03 03 03 03 03 03 03 03 03 03 03 03 03 03 03 03 03 03 03 03 03 03 03 03 03 03 03 03 03 03 03 03 03 03 03 03 03 03 03 03 03 03 03 03 03 03 03 03 03 03 03 03 03 03 03 03 03 03 03 03 06 03 03 03 03 03 03 03 03 03 03 03 03 03 03 03 03 03 03 -1 03 03 03 03 03 03 03 03 03 03 03 03 03 03 03 03 03 03 03 03 03 03 03 03 03 03 03 03 03 03 03 03 07
07 03 03 03 03 03 03 03 03 03 03 03 03 03 03 03 06 03 07 06 03 03 03 03 03 03 03 03 03 03 03 03 03 03 03 03 03 03 03 03 03 03 03 03 03 03 03 03 03 03 03 03 03 03 03 03 03 03 03 03 03 03 03 03 03 03 03 03 03 03 03 03 03 03 03 03 03 03 03 03 03 03 03 03 03 03 03 03 03 03 03 03 03 03 03 03 03 03 03 03 03 03 03 03 03 03 03 03 03 03 03 03 03 03 03 03 03 03 03 03 03 03 03 03 03 03 03 03 03 03 03 03 03 03 03 03 03 03 03 03 03 03 03 03 03 03 03 03 03 03 03 03 03 03 03 03 03 03 03 03 03 03 -1 03 03 03 03 03 03 03 07 03 03 03 03 03 03 03 03 03 03 03 03 03 03 03 03 03 03 06 -1 03 03 03 03 03 03 03 03 03 03 03 03 03 03 03 03 03 03 03 03 03 03 03 03 03 03 03 03 03 03 03 03 07
07 03 03 03 03 03 03 03 03 03 03 03 03 03 03 06 03 03 03 03 03 03 03 03 03 03 03 03 03 03 03 03 03 03 03 03 03 03 03 03 03 03 03 03 03 03 03 03 03 03 03 03 03 03 03 03 03 03 03 03 03 03 03 03 03 03 03 03 03 03 03 03 03 03 03 03 03 03 03 03 03 03 03 03 03 03 03 03 03 03 03 03 03 03 03 03 03 03 03 03 03 03 03 03 03 03 03 03 03 03 03 03 03 03 03 03 03 03 03 03 03 03 03 03 03 03 03 03 03 03 03 03 03 03 03 03 03 03 03 03 03 03 03 03 03 03 03 03 03 03 03 03 03 03 03 03 03 03 03 03 03 -1 -1 -1 03 03 03 03 03 07 03 03 06 03 03 03 03 03 03 03 03 03 03 03 03 03 03 03 -1 03 -1 -1 06 03 03 03 03 03 03 03 03 03 03 03 03 03 03 03 03 03 03 03 03 03 03 03 03 03 03 03 03 03 03 07
07 03 03 03 03 03 03 03 03 03 03 03 03 03 03 03 06 03 03 07 03 03 03 03 03 03 03 03 03 03 03 03 03 03 03 03 03 03 03 03 03 03 03 03 03 03 03 03 03 03 03 03 03 03 03 03 03 03 03 03 03 03 03 03 03 03 03 03 03 03 03 03 03 03 03 03 03 03 03 03 03 03 03 03 03 03 03 03 03 03 03 03 03 03 03 03 03 03 03 03 03 03 03 03 03 03 03 03 03 03 03 03 03 03 03 03 03 03 03 03 03 03 03 03 03 03 03 03 03 03 03 03 03 03 03 03 03 03 03 03 03 03 03 03 03 03 03 03 03 03 03 03 03 03 03 03 03 03 03 03 03 -1 -1 -1 03 03 03 03 06 03 03 03 03 07 03 03 03 03 03 03 03 03 03 03 03 03 03 03 -1 03 -1 -1 03 03 03 03 03 03 03 03 03 03 03 03 03 03 03 03 03 03 03 03 03 03 03 03 03 03 03 03 03 03 03 07
07 00 00 03 03 03 03 03 03 03 03 03 03 03 03 03 03 06 06 03 03 03 03 03 03 03 03 03 03 03 03 03 03 03 03 03 03 06 03 03 03 03 03 03 03 03 03 03 03 03 03 03 03 03 03 03 03 03 03 03 03 03 03 03 03 03 03 03 03 03 03 03 03 03 03 03 03 03 03 03 03 03 03 03 03 03 03 03 03 03 03 03 03 03 03 03 03 03 03 03 03 03 03 03 03 03 03 03 03 03 03 03 03 03 03 03 03 03 03 03 03 03 03 03 03 03 03 03 03 03 03 03 03 03 03 03 03 03 03 03 03 03 03 03 03 03 03 03 03 03 03 03 03 03 03 03 03 03 03 03 03 -1 -1 -1 03 03 03 03 03 03 03 03 03 06 03 03 03 03 03 03 03 03 03 03 03 03 03 03 -1 03 -1 -1 03 03 03 03 03 03 03 03 03 03 03 03 03 03 03 03 03 03 03 03 03 03 03 03 03 03 03 03 03 00 00 07
07 00 00 00 00 03 03 03 03 03 03 03 03 03 03 -1 03 03 03 03 03 03 03 03 03 03 03 03 03 03 03 03 03 03 03 03 03 -1 03 03 03 03 03 03 03 03 03 03 03 03 03 03 03 03 03 03 03 03 03 03 03 03 03 03 03 03 03 03 03 03 03 03 03 03 03 03 03 03 03 03 03 03 03 03 03 07 03 03 03 03 03 03 03 03 03 03 03 03 03 03 03 03 03 03 03 03 03 03 03 03 03 03 03 03 03 03 03 03 03 03 03 03 03 03 03 03 03 03 06 -1 03 03 03 03 03 03 03 03 03 03 03 03 03 03 03 03 -1 06 03 -1 -1 03 03 03 03 03 03 03 03 03 03 -1 -1 -1 03 03 03 03 03 06 03 03 07 03 03 03 03 03 03 03 03 03 03 03 03 03 03 -1 -1 03 -1 -1 03 03 03 03 03 03 03 03 03 03 03 03 03 03 03 03 03 03 03 03 03 03 03 03 03 03 03 00 00 00 00 07
07 00 00 00 00 00 03 03 03 03 03 03 03 03 03 -1 03 -1 03 03 03 03 03 03 03 03 03 03 03 03 03 03 03 03 03 03 03 -1 -1 03 03 06 06 03 03 03 03 03 03 03 03 03 03 03 03 03 03 03 03 03 03 03 03 03 03 03 03 03 03 03 03 03 03 03 03 03 03 03 03 03 03 07 -1 -1 -1 06 -1 -1 -1 -1 07 03 03 03 03 03 03 03 03 03 03 03 03 03 03 03 03 03 03 03 03 03 03 03 03 03 03 03 03 03 03 03 03 03 03 03 03 -1 -1 -1 03 03 -1 03 03 03 03 03 03 03 03 03 03 03 -1 -1 -1 -1 -1 -1 -1 -1 03 03 03 03 03 03 03 03 -1 -1 -1 -1 -1 03 03 03 03 03 06 07 03 03 03 03 03 03 03 03 03 03 03 03 03 03 03 -1 -1 -1 -1 -1 03 03 03 03 03 03 03 03 03 03 03 03 03 03 03 03 03 03 03 03 03 03 03 03 03 03 00 00 00 00 00 07
07 00 00 00 00 00 00 03 03 03 03 03 03 03 03 -1 03 -1 03 03 03 03 03 03 03 03 03 03 03 03 03 03 03 03 03 03 -1 -1 -1 03 03 03 03 03 03 03 03 03 03 03 03 03 03 03 03 03 03 03 03 03 03 03 03 03 03 03 03 03 03 07 03 03 03 03 03 03 03 03 03 03 -1 06 -1 -1 -1 -1 -1 -1 -1 -1 06 -1 03 03 03 03 03 03 03 03 03 03 03 03 03 03 03 03 03 03 03 03 03 03 03 03 03 03 03 03 03 03 03 03 03 -1 03 -1 -1 -1 03 -1 -1 -1 -1 03 06 03 03 03 03 03 03 -1 -1 -1 03 03 03 03 -1 -1 03 03 03 03 03 03 03 03 -1 -1 -1 -1 -1 03 03 03 03 03 03 03 03 03 03 03 03 03 03 03 03 03 03 03 03 03 -1 -1 -1 -1 -1 -1 -1 03 03 03 03 03 03 03 03 03 03 03 03 07 03 03 03 03 03 03 03 03 03 03 03 00 00 00 00 00 00 07
07 00 00 00 00 00 00 03 03 03 03 03 03 -1 03 -1 -1 -1 03 03 03 03 03 03 03 03 03 03 03 03 03 03 03 03 03 03 -1 -1 03 03 03 03 03 03 03 -1 06 06 03 03 03 03 03 03 03 03 03 03 03 03 03 03 03 03 03 03 03 03 03 06 -1 -1 -1 -1 -1 03 -1 07 -1 -1 -1 06 -1 -1 03 03 03 -1 -1 -1 -1 -1 -1 03 03 03 03 03 03 03 03 03 03 03 03 -1 03 03 03 03 03 03 03 03 03 03 03 03 03 03 03 03 03 03 03 -1 -1 -1 -1 -1 03 -1 -1 -1 -1 03 -1 03 03 03 03 03 -1 -1 -1 03 03 03 06 03 03 -1 03 03 03 03 03 03 03 03 -1 -1 -1 -1 -1 03 03 03 03 03 -1 -1 03 03 03 03 03 03 03 03 03 03 03 03 03 03 -1 -1 -1 03 -1 -1 -1 03 03 03 03 03 03 03 03 03 03 03 07 06 07 03 03 03 03 03 03 03 03 03 03 00 00 00 00 00 00 07
07 00 00 00 00 00 00 00 03 03 03 03 -1 -1 06 -1 -1 -1 03 -1 03 03 03 03 03 03 03 03 03 03 03 03 03 03 03 06 -1 -1 03 03 03 03 03 03 -1 -1 -1 06 -1 -1 03 06 03 03 03 03 03 03 03 03 03 03 03 03 03 03 03 03 03 -1 -1 03 03 -1 -1 -1 -1 06 -1 -1 -1 -1 -1 03 03 03 03 03 03 03 03 -1 -1 -1 -1 -1 03 03 03 03 03 03 03 03 03 -1 03 03 03 03 03 06 03 03 03 03 03 03 03 03 03 03 03 03 -1 -1 -1 -1 03 -1 -1 -1 -1 03 -1 -1 -1 -1 -1 03 03 -1 -1 -1 -1 03 03 07 06 07 03 -1 -1 03 03 03 03 03 03 -1 -1 -1 -1 -1 -1 03 03 03 03 -1 -1 -1 -1 03 03 03 03 03 03 03 03 03 03 03 06 -1 -1 03 03 03 03 -1 -1 06 03 03 03 03 03 03 03 03 03 07 06 06 06 07 03 03 03 03 03 03 03 03 00 00 00 00 00 00 00 07
07 00 00 00 00 00 00 00 03 03 03 03 -1 -1 -1 -1 -1 -1 -1 -1 03 03 03 03 03 03 03 03 03 03 03 03 03 03 03 -1 -1 -1 03 03 -1 -1 03 03 03 -1 -1 -1 -1 03 03 03 -1 -1 -1 03 03 03 03 03 03 03 03 03 03 03 03 03 -1 -1 03 03 03 03 03 -1 -1 -1 -1 -1 -1 -1 03 03 03 03 03 03 03 03 03 -1 -1 -1 -1 -1 03 03 03 03 03 03 03 03 -1 -1 -1 03 03 03 06 03 07 03 03 03 03 03 03 03 03 03 03 03 -1 -1 03 03 03 03 -1 -1 03 03 03 03 -1 -1 -1 -1 -1 -1 -1 03 03 03 06 03 03 06 03 -1 -1 -1 03 03 03 03 03 -1 -1 -1 -1 -1 -1 03 03 03 -1 -1 -1 -1 -1 -1 03 03 03 03 03 03 03 03 03 03 -1 -1 -1 03 03 03 03 -1 -1 -1 03 -1 -1 03 -1 03 03 03 07 06 06 03 06 06 07 03 03 03 03 03 03 03 00 00 00 00 00 00 00 07
07 00 00 00 00 00 00 00 00 03 03 03 03 -1 -1 -1 -1 -1 -1 -1 -1 03 03 03 03 03 03 03 03 03 03 03 03 03 03 -1 -1 03 03 -1 -1 -1 -1 03 03 -1 -1 -1 -1 03 03 -1 -1 -1 -1 -1 06 03 03 03 03 03 03 03 03 03 03 -1 -1 -1 03 03 03 03 03 03 03 03 -1 -1 -1 -1 03 03 03 03 03 03 03 03 03 03 -1 -1 -1 -1 -1 03 03 03 03 03 -1 -1 -1 -1 -1 -1 03 06 03 03 06 07 03 03 03 03 03 03 03 03 -1 -1 -1 -1 03 03 03 03 -1 -1 03 03 03 03 03 03 -1 -1 -1 -1 03 03 03 03 07 03 03 06 07 03 -1 -1 -1 03 03 03 03 -1 -1 -1 -1 -1 -1 03 03 03 -1 -1 -1 -1 -1 -1 03 03 03 03 03 03 03 03 03 -1 -1 -1 03 03 03 03 03 03 -1 -1 -1 -1 -1 03 -1 -1 -1 07 06 06 03 03 03 06 06 03 03 03 03 03 03 00 00 00 00 00 00 00 00 07
07 00 00 00 00 00 00 00 00 03 03 03 03 -1 -1 -1 -1 -1 -1 -1 -1 03 03 03 03 03 03 03 03 03 03 03 03 03 -1 -1 -1 03 03 -1 -1 -1 -1 03 03 -1 -1 -1 -1 03 03 -1 -1 -1 -1 -1 -1 -1 -1 03 03 03 03 03 03 03 03 -1 -1 03 03 03 03 03 03 03 03 03 03 -1 -1 -1 03 03 03 03 03 03 03 03 03 03 03 -1 -1 -1 -1 -1 03 03 03 03 -1 -1 -1 -1 -1 -1 03 06 03 03 03 06 03 03 03 03 03 03 03 03 -1 -1 03 03 03 03 03 03 -1 -1 03 03 03 03 03 03 03 03 -1 -1 -1 03 03 03 06 03 03 03 06 06 03 -1 -1 03 03 03 -1 -1 -1 -1 -1 -1 -1 03 03 -1 -1 -1 -1 -1 -1 -1 -1 03 03 03 03 03 03 03 03 -1 -1 03 03 03 03 03 03 03 03 -1 -1 -1 -1 -1 -1 -1 -1 06 06 06 03 03 03 06 06 03 03 03 03 03 03 00 00 00 00 00 00 00 00 07
07 07 07 07 07 07 07 07 07 05 05 05 05 06 -1 -1 -1 -1 06 -1 -1 -1 05 05 05 05 05 05 05 05 05 05 05 05 -1 -1 -1 05 06 -1 -1 -1 05 05 05 05 -1 -1 06 05 05 05 -1 -1 05 05 06 -1 -1 05 05 05 05 05 05 05 05 -1 -1 06 05 05 05 05 05 05 05 05 05 06 -1 -1 05 05 05 05 05 05 06 05 05 05 05 06 -1 -1 -1 06 05 05 05 05 05 05 05 05 -1 -1 -1 05 06 06 07 05 05 05 05 05 05 05 05 -1 -1 -1 05 05 06 05 05 05 -1 -1 05 05 05 06 05 05 05 05 -1 -1 -1 -1 05 05 05 07 07 07 06 05 05 -1 -1 -1 05 05 06 06 06 06 06 06 06 05 05 -1 -1 06 -1 -1 06 -1 -1 -1 05 05 05 05 05 05 -1 -1 -1 05 05 05 05 05 05 05 05 -1 05 05 -1 -1 06 -1 -1 06 07 07 07 07 07 05 05 05 05 05 05 05 05 07 07 07 07 07 07 07 07 07
