06 06 06 06 06 06 06 06 06 06 06 06 06 06 06 06 06 06 06 06 06 06 06 06 06 06 06 06 06 06 06 06 06 06 06 06 06 06 06 06 06 06 06 06 06 06 06 06 06 06 06 06 06 06 06 06 06 06 06 06 06 06 06 06 06 06 06 06 06 06 06 06 06 06 06 06 06 06 06 06 06 06 06 06 06 06 06 06 06 06 06 06 06 06 06 06 06 06 06 06
05 05 05 05 06 06 05 05 06 06 06 05 05 05 03 03 05 05 06 05 05 05 06 05 05 05 03 05 05 05 06 06 05 03 06 05 05 06 06 03 05 06 05 03 05 06 06 05 05 03 05 06 06 05 03 03 05 05 06 06 05 05 05 05 06 06 05 05 05 05 06 06 05 05 05 06 05 05 03 03 05 05 06 05 05 03 05 05 06 06 05 05 06 06 06 05 06 06 06 06
05 03 05 03 05 05 03 03 05 06 05 03 05 03 03 03 03 03 05 03 05 03 05 05 03 03 03 03 03 05 06 05 03 03 05 03 03 05 05 03 03 05 03 02 03 05 05 03 03 03 05 06 06 05 03 03 03 05 06 05 03 05 05 05 -1 05 05 05 03 03 05 06 06 05 05 06 05 03 03 03 03 02 06 05 03 03 03 05 06 05 03 05 06 06 05 03 05 06 05 06
03 03 03 03 03 03 03 03 05 06 05 03 03 03 03 03 03 03 05 03 03 03 03 03 03 03 03 03 03 03 05 03 03 03 03 03 03 03 03 03 03 03 01 03 01 05 03 03 03 03 03 05 06 05 03 03 03 03 05 03 03 03 05 05 02 02 05 03 03 03 03 05 05 03 03 05 03 03 03 03 02 01 05 03 03 03 03 03 05 03 03 03 06 06 05 03 03 05 05 06
03 03 03 03 03 03 03 03 03 05 03 03 03 03 03 03 03 03 03 03 03 03 03 03 03 03 03 03 03 03 03 03 03 03 03 03 03 03 03 03 03 02 03 03 05 05 03 03 03 03 03 03 05 03 03 03 03 03 03 03 03 03 05 -1 -1 02 03 03 03 03 03 03 03 03 03 05 03 03 03 03 02 05 05 03 03 03 03 03 03 03 03 03 05 05 03 03 03 03 05 06
03 03 03 03 03 03 03 03 03 03 03 03 03 03 03 03 03 03 03 03 03 03 03 03 03 03 02 03 02 03 03 03 03 03 03 03 03 03 03 03 03 03 01 05 05 03 03 03 03 03 03 03 03 03 03 03 03 03 03 03 03 03 -1 -1 -1 -1 03 03 03 03 03 03 03 03 03 03 03 03 03 03 03 03 03 03 03 03 03 03 03 03 03 03 03 03 03 03 03 03 05 06
00 03 03 03 03 03 03 03 03 03 03 03 03 03 03 03 03 03 03 03 03 03 03 03 03 02 03 01 03 02 03 03 03 03 03 03 03 03 03 03 03 03 02 03 03 03 03 03 03 03 03 03 03 03 03 03 03 03 03 03 03 03 -1 -1 -1 -1 03 03 03 03 03 03 03 03 03 03 03 03 03 03 02 03 03 02 03 03 03 03 03 03 03 03 03 03 03 03 03 03 05 06
00 03 03 03 03 03 03 03 03 03 03 03 03 03 03 03 03 03 03 03 03 03 03 03 03 03 01 -1 01 03 03 03 03 03 03 03 03 03 03 03 03 03 03 03 03 03 03 03 03 03 03 03 03 03 03 03 03 03 03 03 03 -1 -1 -1 -1 -1 -1 -1 03 03 03 03 03 03 03 03 03 03 01 05 05 03 01 03 03 03 03 03 03 03 03 03 03 03 03 03 03 03 05 06
00 00 03 03 03 03 03 03 03 03 03 03 03 03 03 03 03 03 03 03 03 03 03 03 03 02 03 01 03 02 03 03 03 03 03 03 03 03 03 03 03 03 03 03 03 03 03 03 03 03 03 03 03 03 03 03 03 03 03 03 03 -1 -1 -1 -1 -1 -1 -1 -1 03 03 03 03 03 03 03 03 01 05 05 06 05 01 02 03 03 03 03 03 03 03 03 03 03 03 03 03 03 05 06
00 00 03 03 03 03 03 03 03 03 03 03 03 03 03 03 03 03 03 03 03 03 03 03 03 03 02 03 02 03 03 03 03 03 03 03 03 03 03 03 03 03 03 06 03 03 01 03 03 03 03 03 03 03 03 03 03 03 03 03 03 -1 -1 -1 -1 -1 -1 -1 -1 03 03 03 03 03 03 03 03 05 05 -1 -1 06 05 03 02 03 03 03 03 03 03 03 03 03 03 03 03 03 05 06
00 00 03 03 03 03 03 03 03 03 03 03 03 03 03 03 03 03 03 03 03 03 03 03 03 03 03 03 03 03 03 03 03 03 03 03 03 03 03 03 03 03 05 02 03 06 05 03 03 03 03 03 03 03 03 03 03 03 03 03 -1 -1 -1 -1 -1 -1 -1 -1 -1 03 03 03 03 03 03 03 03 05 05 -1 -1 06 05 02 02 03 03 03 03 03 03 03 03 03 03 03 03 05 05 06
00 00 00 03 03 03 03 03 03 03 03 03 03 03 03 03 03 03 03 03 03 03 03 03 03 03 03 03 03 03 03 03 03 03 03 03 03 03 03 03 03 01 03 03 -1 02 03 03 03 03 03 03 03 03 03 03 03 03 03 03 -1 -1 -1 -1 -1 -1 -1 -1 -1 -1 03 03 03 03 03 03 02 01 05 05 06 05 01 03 03 03 03 03 03 03 03 03 03 03 03 03 05 05 05 06
00 00 00 03 03 03 03 03 03 03 03 03 03 03 03 03 03 03 03 03 03 03 03 03 03 03 03 03 03 03 03 03 03 03 03 03 03 03 03 03 03 03 03 02 06 05 03 03 03 03 03 03 03 03 03 03 03 03 03 03 -1 -1 -1 -1 -1 -1 -1 -1 -1 -1 03 03 03 03 03 03 02 03 03 05 05 05 03 02 03 03 03 03 03 03 03 03 03 03 03 03 03 03 05 05
00 00 00 00 00 03 03 03 03 03 03 03 03 03 03 03 03 03 03 03 03 03 03 03 03 03 03 03 03 03 03 03 03 03 03 03 03 03 03 03 03 03 03 05 03 01 03 03 03 03 03 03 03 03 03 03 03 03 03 -1 -1 -1 -1 -1 -1 -1 -1 -1 -1 -1 03 03 03 03 03 03 03 03 02 01 03 01 02 03 03 03 03 03 03 03 03 03 03 03 03 03 03 03 03 03
00 00 00 00 00 03 03 03 03 03 03 03 03 03 03 03 03 03 03 03 03 03 03 03 03 03 03 03 03 03 03 03 03 03 03 03 03 03 03 03 03 03 03 03 03 03 03 03 03 03 03 03 03 03 03 03 03 03 03 -1 -1 -1 -1 -1 -1 -1 -1 -1 -1 -1 03 03 03 03 03 03 03 03 03 03 03 03 03 03 03 03 03 03 03 03 03 03 03 03 03 03 03 03 03 03
00 00 00 00 00 00 03 03 03 03 03 03 03 03 03 03 03 03 03 03 03 03 03 03 03 03 03 03 03 03 03 03 03 03 03 03 03 03 03 03 03 03 03 03 03 03 03 03 03 03 03 03 03 03 03 03 03 03 -1 -1 -1 -1 -1 -1 -1 -1 -1 -1 -1 -1 03 03 03 03 03 03 03 03 03 03 03 03 03 03 03 03 03 03 03 03 03 03 03 03 03 03 03 03 03 03
00 00 00 00 00 00 00 03 03 03 03 03 03 03 03 03 03 03 03 03 03 03 03 03 03 03 03 03 03 03 03 03 03 03 03 03 03 03 03 03 03 03 03 03 03 03 03 03 03 03 03 03 03 03 03 03 03 03 -1 -1 -1 -1 -1 -1 -1 -1 -1 -1 -1 -1 -1 03 03 03 03 03 03 03 03 03 03 03 03 03 03 03 03 03 03 03 03 03 03 03 03 03 03 03 03 03
00 00 00 00 00 00 00 03 03 03 03 03 03 03 03 03 03 03 03 03 03 03 03 03 03 03 03 03 03 03 03 03 03 03 03 03 03 03 03 03 03 03 03 03 03 03 03 03 03 03 03 03 03 03 03 03 03 03 -1 -1 -1 -1 -1 -1 -1 -1 -1 -1 -1 -1 -1 03 03 03 03 03 03 03 03 03 03 03 03 03 03 03 03 03 03 03 03 03 03 03 03 03 03 03 03 03
00 00 00 00 00 00 00 03 03 03 03 03 03 03 03 03 03 03 03 03 03 03 03 03 03 03 03 03 03 03 03 03 03 03 03 03 03 03 03 03 03 03 03 03 03 03 03 03 03 03 03 03 03 03 03 03 03 03 -1 -1 -1 -1 -1 -1 -1 -1 -1 -1 -1 -1 -1 03 03 03 03 03 03 03 03 03 03 03 03 03 03 03 03 03 03 03 03 03 03 03 03 03 03 03 03 03
06 06 06 06 06 06 06 06 04 04 04 04 04 04 04 04 04 04 04 04 04 04 04 04 04 04 04 04 04 04 04 04 04 04 04 04 04 04 04 05 05 05 05 05 05 05 05 04 04 04 04 04 04 04 04 04 04 06 05 05 -1 -1 -1 05 -1 05 -1 -1 -1 05 05 06 04 04 04 04 04 04 04 04 04 04 04 04 04 04 04 04 04 04 04 04 04 04 06 06 06 06 06 06
06 06 06 06 06 06 06 06 06 04 04 04 04 04 04 04 04 04 04 04 04 04 04 04 04 04 04 04 04 04 04 04 04 04 04 04 04 04 04 04 06 06 06 06 06 06 06 06 04 04 04 04 04 04 04 04 04 06 06 06 -1 -1 -1 06 -1 06 -1 -1 -1 06 06 06 04 04 04 04 04 04 04 04 04 04 04 04 04 04 04 04 04 04 04 04 06 06 06 06 06 06 06 06
