07 07 07 07 07 07 07 07 07 07 07 07 07 07 07 07 07 07 07 07 07 07 07 07 07 07 07 07 07 07 07 07 07 07 07 07 07 07 07 07 07 07 07 07 07 07 07 07 07 07 07 07 07 07 07 07 07 07 07 07 07 07 07 07 07 07 07 07 07 07 07 07 07 07 07 07 07 07 07 07 07 07 07 07 07 07 07 07 07 07 07 07 07 07 07 07 07 07 07 07 07 07 07 07
07 06 06 06 06 07 07 06 06 07 07 07 06 06 06 03 03 06 06 07 06 06 06 07 06 06 06 03 06 06 06 07 07 06 03 07 06 06 07 07 03 06 07 06 03 06 07 07 06 06 03 06 07 07 06 03 03 06 06 07 07 06 06 06 06 07 07 06 06 06 06 07 07 06 06 06 07 06 06 03 03 06 06 07 06 06 03 06 06 07 07 06 06 07 07 07 06 07 07 07 07 07 07 07
07 06 03 06 03 06 06 03 03 06 07 06 03 06 03 03 03 03 03 06 03 06 03 06 06 03 03 03 03 03 06 07 06 03 03 06 03 03 06 06 03 03 06 03 02 03 06 06 03 03 03 06 07 07 06 03 03 03 06 07 06 03 06 06 06 -1 06 06 06 03 03 06 07 07 06 06 07 06 03 03 03 03 02 07 06 03 03 03 06 07 06 03 06 07 07 06 03 06 07 06 07 07 07 07
07 03 03 03 03 03 03 03 03 06 07 06 03 03 03 03 03 03 03 06 03 03 03 03 03 03 03 03 03 03 03 06 03 03 03 03 03 03 03 03 03 03 03 01 03 01 06 03 03 03 03 03 06 07 06 03 03 03 03 06 03 03 03 06 06 02 02 06 03 03 03 03 06 06 03 03 06 03 03 03 03 02 01 06 03 03 03 03 03 06 03 03 03 07 07 06 03 03 06 06 07 07 07 07
07 03 03 03 03 03 03 03 03 03 06 03 03 03 03 03 03 03 03 03 03 03 03 03 03 03 03 03 03 03 03 03 03 03 03 03 03 03 03 03 03 03 02 03 03 06 06 03 03 03 03 03 03 06 03 03 03 03 03 03 03 03 03 06 -1 -1 02 03 03 03 03 03 03 03 03 03 06 03 03 03 03 02 06 06 03 03 03 03 03 03 03 03 03 06 06 03 03 03 03 06 07 07 07 07
07 03 03 03 03 03 03 03 03 03 03 03 03 03 03 03 03 03 03 03 03 03 03 03 03 03 03 02 03 02 03 03 03 03 03 03 03 03 03 03 03 03 03 01 06 06 03 03 03 03 03 03 03 03 03 03 03 03 03 03 03 03 03 -1 -1 -1 -1 03 03 03 03 03 03 03 03 03 03 03 03 03 03 03 03 03 03 03 03 03 03 03 03 03 03 03 03 03 03 03 03 06 07 07 07 07
07 00 03 03 03 03 03 03 03 03 03 03 03 03 03 03 03 03 03 03 03 03 03 03 03 03 02 03 01 03 02 03 03 03 03 03 03 03 03 03 03 03 03 02 03 03 03 03 03 03 03 03 03 03 03 03 03 03 03 03 03 03 03 -1 -1 -1 -1 03 03 03 03 03 03 03 03 03 03 03 03 03 03 02 03 03 02 03 03 03 03 03 03 03 03 03 03 03 03 03 03 06 07 07 07 07
07 00 03 03 03 03 03 03 03 03 03 03 03 03 03 03 03 03 03 03 03 03 03 03 03 03 03 01 -1 01 03 03 03 03 03 03 03 03 03 03 03 03 03 03 03 03 03 03 03 03 03 03 03 03 03 03 03 03 03 03 03 03 -1 -1 -1 -1 -1 -1 -1 03 03 03 03 03 03 03 03 03 03 01 06 06 03 01 03 03 03 03 03 03 03 03 03 03 03 03 03 03 03 06 07 07 07 07
07 00 00 03 03 03 03 03 03 03 03 03 03 03 03 03 03 03 03 03 03 03 03 03 03 03 02 03 01 03 02 03 03 03 03 03 03 03 03 03 03 03 03 03 03 03 03 03 03 03 03 03 03 03 03 03 03 03 03 03 03 03 -1 -1 -1 -1 -1 -1 -1 -1 03 03 03 03 03 03 03 03 01 06 06 07 06 01 02 03 03 03 03 03 03 03 03 03 03 03 03 03 03 06 07 07 07 07
07 00 00 03 03 03 03 03 03 03 03 03 03 03 03 03 03 03 03 03 03 03 03 03 03 03 03 02 03 02 03 03 03 03 03 03 03 03 03 03 03 03 03 03 07 03 03 01 03 03 03 03 03 03 03 03 03 03 03 03 03 03 -1 -1 -1 -1 -1 -1 -1 -1 03 03 03 03 03 03 03 03 06 06 -1 -1 07 06 03 02 03 03 03 03 03 03 03 03 03 03 03 03 03 06 07 07 07 07
07 00 00 03 03 03 03 03 03 03 03 03 03 03 03 03 03 03 03 03 03 03 03 03 03 03 03 03 03 03 03 03 03 03 03 03 03 03 03 03 03 03 03 06 02 03 07 06 03 03 03 03 03 03 03 03 03 03 03 03 03 -1 -1 -1 -1 -1 -1 -1 -1 -1 03 03 03 03 03 03 03 03 06 06 -1 -1 07 06 02 02 03 03 03 03 03 03 03 03 03 03 03 03 06 06 07 07 07 07
07 00 00 00 03 03 03 03 03 03 03 03 03 03 03 03 03 03 03 03 03 03 03 03 03 03 03 03 03 03 03 03 03 03 03 03 03 03 03 03 03 03 01 03 03 -1 02 03 03 03 03 03 03 03 03 03 03 03 03 03 03 -1 -1 -1 -1 -1 -1 -1 -1 -1 -1 03 03 03 03 03 03 02 01 06 06 07 06 01 03 03 03 03 03 03 03 03 03 03 03 03 03 06 06 07 07 07 07 07
07 00 00 00 03 03 03 03 03 03 03 03 03 03 03 03 03 03 03 03 03 03 03 03 03 03 03 03 03 03 03 03 03 03 03 03 03 03 03 03 03 03 03 03 02 07 06 03 03 03 03 03 03 03 03 03 03 03 03 03 03 -1 -1 -1 -1 -1 -1 -1 -1 -1 -1 03 03 03 03 03 03 02 03 03 06 06 06 03 02 03 03 03 03 03 03 03 03 03 03 03 03 03 00 07 07 07 07 07
07 00 00 00 00 00 03 03 03 03 03 03 03 03 03 03 03 03 03 03 03 03 03 03 03 03 03 03 03 03 03 03 03 03 03 03 03 03 03 03 03 03 03 03 06 03 01 03 03 03 03 03 03 03 03 03 03 03 03 03 -1 -1 -1 -1 -1 -1 -1 -1 -1 -1 -1 03 03 03 03 03 03 03 03 02 01 03 01 02 03 03 03 03 03 03 03 03 03 03 03 03 03 03 00 00 00 00 00 07
07 00 00 00 00 00 03 03 03 03 03 03 03 03 03 03 03 03 03 03 03 03 03 03 03 03 03 03 03 03 03 03 03 03 03 03 03 03 03 03 03 03 03 03 03 03 03 03 03 03 03 03 03 03 03 03 03 03 03 03 -1 -1 -1 -1 -1 -1 -1 -1 -1 -1 -1 03 03 03 03 03 03 03 03 03 03 03 03 03 03 03 03 03 03 03 03 03 03 03 03 03 03 00 00 00 00 00 00 07
07 00 00 00 00 00 00 03 03 03 03 03 03 03 03 03 03 03 03 03 03 03 03 03 03 03 03 03 03 03 03 03 03 03 03 03 03 03 03 03 03 03 03 03 03 03 03 03 03 03 03 03 03 03 03 03 03 03 03 -1 -1 -1 -1 -1 -1 -1 -1 -1 -1 -1 -1 03 03 03 03 03 03 03 03 03 03 03 03 03 03 03 03 03 03 03 03 03 03 03 03 03 03 00 00 00 00 00 00 07
07 00 00 00 00 00 00 00 03 03 03 03 03 03 03 03 03 03 03 03 03 03 03 03 03 03 03 03 03 03 03 03 03 03 03 03 03 03 03 03 03 03 03 03 03 03 03 03 03 03 03 03 03 03 03 03 03 03 03 -1 -1 -1 -1 -1 -1 -1 -1 -1 -1 -1 -1 -1 03 03 03 03 03 03 03 03 03 03 03 03 03 03 03 03 03 03 03 03 03 03 03 03 00 00 00 00 00 00 00 07
07 00 00 00 00 00 00 00 03 03 03 03 03 03 03 03 03 03 03 03 03 03 03 03 03 03 03 03 03 03 03 03 03 03 03 03 03 03 03 03 03 03 03 03 03 03 03 03 03 03 03 03 03 03 03 03 03 03 03 -1 -1 -1 -1 -1 -1 -1 -1 -1 -1 -1 -1 -1 03 03 03 03 03 03 03 03 03 03 03 03 03 03 03 03 03 03 03 03 03 03 03 03 00 00 00 00 00 00 00 07
07 00 00 00 00 00 00 00 03 03 03 03 03 03 03 03 03 03 03 03 03 03 03 03 03 03 03 03 03 03 03 03 03 03 03 03 03 03 03 03 03 03 03 03 03 03 03 03 03 03 03 03 03 03 03 03 03 03 03 -1 -1 -1 -1 -1 -1 -1 -1 -1 -1 -1 -1 -1 03 03 03 03 03 03 03 03 03 03 03 03 03 03 03 03 03 03 03 03 03 03 03 00 00 00 00 00 00 00 00 07
07 07 07 07 07 07 07 07 07 04 04 04 04 04 04 04 04 04 04 04 04 04 04 04 04 04 04 04 04 04 04 04 04 04 04 04 04 04 04 04 06 06 06 06 06 06 06 06 04 04 04 04 04 04 04 04 04 04 07 06 06 -1 -1 -1 06 -1 06 -1 -1 -1 06 06 07 04 04 04 04 04 04 04 04 04 04 04 04 04 04 04 04 04 04 04 04 06 06 07 07 07 07 07 07 07 07 07
