07 07 07 07 07 07 07 07 07 07 07 07 07 07 07 07 07 07 07 07 07 07 07 07 07 07 07 07 07 07 07 07 07 07 07 07 07 07 07 07 07 07 07 07 07 07 07 07 07 07 07 07 07 07 07 07 07 07 07 07 07 07 07 07 07 07 07 07 07 07 07 07 07 07 07 07 07 07 07 07 07 07 07 07 07 07 07 07 07 07 07 07 07 07 07 07 07 07 07 07 07 07 07 07 07 07 07 07 07 07 07 07 07 07 07 07 07 07 07 07 07 07 07 07 07 07 07 07 07 07 07 07 07 07 07 07 07 07 07 07 07 07 07 07 07 07 07 07 07 07 07 07 07 07 07 07 07 07 07 07 07 07 07 07 07 07 07 07 07 07 07 07 07 07 07 07 07 07 07 07 07 07 07 07 07 07 07 07 07 07 07 07 07 07 07 07 07 07 07 07 07 07 07 07 07 07 07 07 07 07 07 07 07 07 07 07 07 07 07 07 07 07 07 07
07 07 07 07 07 07 06 06 06 06 06 06 07 07 07 07 06 06 06 06 07 07 07 07 07 06 07 07 07 07 07 06 06 06 06 06 07 07 07 07 06 06 06 06 07 07 07 07 06 06 06 06 06 06 07 07 07 06 06 06 06 06 06 06 07 07 07 07 06 06 06 06 06 06 07 07 07 07 07 06 06 06 06 06 06 06 06 07 07 07 07 06 06 07 07 07 06 06 06 06 06 06 07 07 07 07 06 06 06 06 06 06 06 06 07 07 07 07 06 06 06 06 06 06 06 07 07 06 06 07 07 07 07 06 06 06 06 06 07 07 07 06 06 06 06 06 06 07 07 07 06 06 06 06 06 06 06 07 07 07 06 06 06 06 06 06 06 07 07 07 07 06 06 06 06 06 06 06 06 07 07 07 07 07 07 07 06 07 07 07 07 07 06 06 06 06 06 06 06 06 07 07 07 06 06 06 06 06 06 07 07 07 06 06 06 06 06 06 06 07 07 07 07 07
07 06 06 07 07 07 06 03 03 03 03 03 06 07 07 06 03 03 03 03 03 06 07 07 06 03 03 06 07 07 06 03 03 03 03 03 06 07 07 06 03 03 03 03 06 07 07 06 03 03 03 03 03 03 06 07 07 06 03 03 03 03 03 03 06 07 07 06 03 03 03 03 03 03 06 07 07 07 06 03 03 03 03 03 03 03 03 06 07 07 06 03 03 06 07 06 03 03 03 03 03 03 06 07 07 06 03 03 03 03 03 03 03 03 06 07 07 06 03 03 03 03 03 03 06 07 06 03 03 06 07 07 06 03 03 03 03 03 06 07 07 06 03 03 03 03 03 06 07 07 06 03 03 03 03 03 03 06 07 06 03 03 03 03 03 03 03 03 06 07 06 03 03 03 03 03 03 03 03 06 07 06 06 07 07 06 03 06 07 07 07 06 03 03 03 03 03 03 03 06 07 07 07 06 03 03 03 03 03 06 07 06 03 03 03 03 03 03 03 06 07 07 06 07
07 03 03 06 07 06 03 03 03 03 03 06 07 07 06 03 03 03 03 03 03 03 06 07 06 03 03 03 06 07 06 03 03 03 03 03 03 06 07 06 03 03 03 03 03 06 07 06 03 03 03 03 03 03 03 06 07 03 03 03 03 03 03 03 03 06 07 06 03 03 03 03 03 03 03 06 07 07 06 03 03 03 03 03 03 03 03 03 06 07 03 03 03 03 06 03 03 03 03 03 03 03 03 06 07 06 03 03 03 03 03 03 03 03 03 06 07 06 03 03 03 03 03 03 06 07 06 03 03 03 06 07 06 03 03 03 03 03 03 06 07 06 03 03 03 03 03 03 06 07 06 03 03 03 03 03 03 03 06 03 03 03 03 03 03 03 03 03 03 06 03 03 03 03 03 03 03 03 06 07 06 03 03 06 07 03 03 03 03 03 07 06 03 03 03 03 03 03 03 03 06 07 06 03 03 03 03 03 03 03 07 06 03 03 03 03 03 03 06 07 07 06 03 07
07 03 03 03 06 03 03 03 03 03 03 03 06 03 03 03 03 03 03 03 03 03 03 06 03 03 03 03 03 06 03 03 03 03 03 03 03 03 06 03 03 03 03 03 03 03 06 03 03 03 03 03 03 03 03 03 06 03 03 03 03 03 03 03 03 03 06 03 03 03 03 03 03 03 03 03 06 07 03 03 03 03 03 03 03 03 03 03 03 06 03 03 03 03 03 06 03 03 03 03 03 03 03 03 06 03 03 03 03 03 03 03 03 03 03 03 06 07 03 03 03 03 03 03 03 06 03 03 03 03 03 06 03 03 03 03 03 03 03 03 06 03 03 03 03 03 03 03 03 06 03 03 03 03 03 03 03 03 06 03 03 03 03 03 03 03 03 03 03 03 03 03 03 03 03 03 06 06 03 03 03 03 03 03 06 03 03 03 03 03 06 03 03 03 03 03 03 03 03 03 03 06 03 03 03 03 03 03 03 03 06 03 03 03 03 03 03 03 03 06 06 06 03 07
07 03 03 03 03 03 03 03 03 03 03 06 03 03 03 03 03 03 03 03 03 03 03 03 03 03 03 03 03 03 03 03 03 03 03 03 03 03 03 03 03 03 03 03 03 03 03 03 03 03 03 03 03 03 03 03 03 03 03 03 03 03 03 03 03 03 03 03 03 03 03 03 03 03 03 03 03 06 03 03 03 03 03 03 03 03 03 03 03 03 03 03 03 03 03 03 03 03 03 03 03 03 03 03 03 03 03 03 03 03 03 03 03 03 03 03 03 06 06 03 03 03 03 03 06 03 03 03 03 03 03 03 03 03 03 03 03 03 03 03 03 03 03 03 03 03 03 03 03 03 03 03 03 03 03 03 03 03 03 03 03 03 03 03 03 03 03 03 03 03 03 03 03 03 03 03 03 03 03 03 03 03 03 03 03 03 03 03 03 03 03 03 03 03 03 03 03 03 03 03 03 03 03 03 03 03 03 03 03 03 03 03 03 03 03 03 03 06 06 03 03 03 03 07
07 03 03 03 03 03 03 03 03 03 03 03 03 03 03 03 03 06 03 03 03 03 03 03 03 03 03 03 03 03 03 03 03 03 03 03 03 03 03 03 03 03 03 03 03 03 03 03 03 03 03 03 03 03 03 03 03 03 03 03 03 03 03 03 03 03 03 03 03 03 03 03 03 03 03 03 03 03 03 03 03 03 03 03 03 03 03 03 03 03 03 03 03 03 03 03 03 03 03 03 03 03 03 03 03 03 03 03 03 03 03 03 03 03 03 03 03 03 03 03 03 03 03 03 03 03 03 03 03 03 03 03 03 03 03 03 03 03 03 03 03 03 03 03 03 03 03 03 03 03 03 03 03 03 03 03 03 03 03 03 03 03 03 03 03 03 03 03 03 03 03 06 03 03 03 03 03 03 03 03 03 03 03 03 03 03 03 03 03 03 -1 03 03 03 03 03 03 03 03 03 03 03 03 03 03 03 03 03 03 03 03 03 03 03 03 03 03 03 03 03 03 03 03 07
07 03 03 03 03 03 03 03 03 03 03 03 03 03 03 03 06 03 07 06 03 03 03 03 03 03 03 03 03 03 03 03 03 03 03 03 03 03 03 03 03 03 03 03 03 03 03 03 03 03 03 03 03 03 03 03 03 03 03 03 03 03 03 03 03 03 03 03 03 03 03 03 03 03 03 03 03 03 03 03 03 03 03 03 03 03 03 03 03 03 03 03 03 03 03 03 03 03 03 03 03 03 03 03 03 03 03 03 03 03 03 03 03 03 03 03 03 03 03 03 03 03 03 03 03 03 03 03 03 03 03 03 03 03 03 03 03 03 03 03 03 03 03 03 03 03 03 03 03 03 03 03 03 03 03 03 03 03 03 03 03 03 -1 03 03 03 03 03 03 03 07 03 03 03 03 03 03 03 03 03 03 03 03 03 03 03 03 03 03 06 -1 03 03 03 03 03 03 03 03 03 03 03 03 03 03 03 03 03 03 03 03 03 03 03 03 03 03 03 03 03 03 03 03 07
07 03 03 03 03 03 03 03 03 03 03 03 03 03 03 06 03 03 03 03 03 03 03 03 03 03 03 03 03 03 03 03 03 03 03 03 03 03 03 03 03 03 03 03 03 03 03 03 03 03 03 03 03 03 03 03 03 03 03 03 03 03 03 03 03 03 03 03 03 03 03 03 03 03 03 03 03 03 03 03 03 03 03 03 03 03 03 03 03 03 03 03 03 03 03 03 03 03 03 03 03 03 03 03 03 03 03 03 03 03 03 03 03 03 03 03 03 03 03 03 03 03 03 03 03 03 03 03 03 03 03 03 03 03 03 03 03 03 03 03 03 03 03 03 03 03 03 03 03 03 03 03 03 03 03 03 03 03 03 03 03 -1 -1 -1 03 03 03 03 03 07 03 03 06 03 03 03 03 03 03 03 03 03 03 03 03 03 03 03 -1 03 -1 -1 06 03 03 03 03 03 03 03 03 03 03 03 03 03 03 03 03 03 03 03 03 03 03 03 03 03 03 03 03 03 03 07
07 03 03 03 03 03 03 03 03 03 03 03 03 03 03 03 06 03 03 07 03 03 03 03 03 03 03 03 03 03 03 03 03 03 03 03 03 03 03 03 03 03 03 03 03 03 03 03 03 03 03 03 03 03 03 03 03 03 03 03 03 03 03 03 03 03 03 03 03 03 03 03 03 03 03 03 03 03 03 03 03 03 03 03 03 03 03 03 03 03 03 03 03 03 03 03 03 03 03 03 03 03 03 03 03 03 03 03 03 03 03 03 03 03 03 03 03 03 03 03 03 03 03 03 03 03 03 03 03 03 03 03 03 03 03 03 03 03 03 03 03 03 03 03 03 03 03 03 03 03 03 03 03 03 03 03 03 03 03 03 03 -1 -1 -1 03 03 03 03 06 03 03 03 03 07 03 03 03 03 03 03 03 03 03 03 03 03 03 03 -1 03 -1 -1 03 03 03 03 03 03 03 03 03 03 03 03 03 03 03 03 03 03 03 03 03 03 03 03 03 03 03 03 03 03 03 07
07 -1 -1 03 03 03 03 03 03 03 03 03 03 03 03 03 03 06 06 03 03 03 03 03 03 03 03 03 03 03 03 03 03 03 03 03 03 06 03 03 03 03 03 03 03 03 03 03 03 03 03 03 03 03 03 03 03 03 03 03 03 03 03 03 03 03 03 03 03 03 03 03 03 03 03 03 03 03 03 03 03 03 03 03 03 03 03 03 03 03 03 03 03 03 03 03 03 03 03 03 03 03 03 03 03 03 03 03 03 03 03 03 03 03 03 03 03 03 03 03 03 03 03 03 03 03 03 03 03 03 03 03 03 03 03 03 03 03 03 03 03 03 03 03 03 03 03 03 03 03 03 03 03 03 03 03 03 03 03 03 03 -1 -1 -1 03 03 03 03 03 03 03 03 03 06 03 03 03 03 03 03 03 03 03 03 03 03 03 03 -1 03 -1 -1 03 03 03 03 03 03 03 03 03 03 03 03 03 03 03 03 03 03 03 03 03 03 03 03 03 03 03 03 03 -1 -1 07
07 -1 -1 -1 -1 03 03 03 03 03 03 03 03 03 03 -1 03 03 03 03 03 03 03 03 03 03 03 03 03 03 03 03 03 03 03 03 03 -1 03 03 03 03 03 03 03 03 03 03 03 03 03 03 03 03 03 03 03 03 03 03 03 03 03 03 03 03 03 03 03 03 03 03 03 03 03 03 03 03 03 03 03 03 03 03 03 07 03 03 03 03 03 03 03 03 03 03 03 03 03 03 03 03 03 03 03 03 03 03 03 03 03 03 03 03 03 03 03 03 03 03 03 03 03 03 03 03 03 03 06 -1 03 03 03 03 03 03 03 03 03 03 03 03 03 03 03 03 -1 06 03 -1 -1 03 03 03 03 03 03 03 03 03 03 -1 -1 -1 03 03 03 03 03 06 03 03 07 03 03 03 03 03 03 03 03 03 03 03 03 03 03 -1 -1 03 -1 -1 03 03 03 03 03 03 03 03 03 03 03 03 03 03 03 03 03 03 03 03 03 03 03 03 03 03 03 -1 -1 -1 -1 07
07 -1 -1 -1 -1 -1 03 03 03 03 03 03 03 03 03 -1 03 -1 03 03 03 03 03 03 03 03 03 03 03 03 03 03 03 03 03 03 03 -1 -1 03 03 06 06 03 03 03 03 03 03 03 03 03 03 03 03 03 03 03 03 03 03 03 03 03 03 03 03 03 03 03 03 03 03 03 03 03 03 03 03 03 03 07 -1 -1 -1 06 -1 -1 -1 -1 07 03 03 03 03 03 03 03 03 03 03 03 03 03 03 03 03 03 03 03 03 03 03 03 03 03 03 03 03 03 03 03 03 03 03 03 03 -1 -1 -1 03 03 -1 03 03 03 03 03 03 03 03 03 03 03 -1 -1 -1 -1 -1 -1 -1 -1 03 03 03 03 03 03 03 03 -1 -1 -1 -1 -1 03 03 03 03 03 06 07 03 03 03 03 03 03 03 03 03 03 03 03 03 03 03 -1 -1 -1 -1 -1 03 03 03 03 03 03 03 03 03 03 03 03 03 03 03 03 03 03 03 03 03 03 03 03 03 03 -1 -1 -1 -1 -1 07
07 -1 -1 -1 -1 -1 -1 03 03 03 03 03 03 03 03 -1 03 -1 03 03 03 03 03 03 03 03 03 03 03 03 03 03 03 03 03 03 -1 -1 -1 03 03 03 03 03 03 03 03 03 03 03 03 03 03 03 03 03 03 03 03 03 03 03 03 03 03 03 03 03 03 07 03 03 03 03 03 03 03 03 03 03 -1 06 -1 -1 -1 -1 -1 -1 -1 -1 06 -1 03 03 03 03 03 03 03 03 03 03 03 03 03 03 03 03 03 03 03 03 03 03 03 03 03 03 03 03 03 03 03 03 03 -1 03 -1 -1 -1 03 -1 -1 -1 -1 03 06 03 03 03 03 03 03 -1 -1 -1 03 03 03 03 -1 -1 03 03 03 03 03 03 03 03 -1 -1 -1 -1 -1 03 03 03 03 03 03 03 03 03 03 03 03 03 03 03 03 03 03 03 03 03 -1 -1 -1 -1 -1 -1 -1 03 03 03 03 03 03 03 03 03 03 03 03 07 03 03 03 03 03 03 03 03 03 03 03 -1 -1 -1 -1 -1 -1 07
07 -1 -1 -1 -1 -1 -1 03 03 03 03 03 03 -1 03 -1 -1 -1 03 03 03 03 03 03 03 03 03 03 03 03 03 03 03 03 03 03 -1 -1 03 03 03 03 03 03 03 -1 06 06 03 03 03 03 03 03 03 03 03 03 03 03 03 03 03 03 03 03 03 03 03 06 -1 -1 -1 -1 -1 03 -1 07 -1 -1 -1 06 -1 -1 03 03 03 -1 -1 -1 -1 -1 -1 03 03 03 03 03 03 03 03 03 03 03 03 -1 03 03 03 03 03 03 03 03 03 03 03 03 03 03 03 03 03 03 03 -1 -1 -1 -1 -1 03 -1 -1 -1 -1 03 -1 03 03 03 03 03 -1 -1 -1 03 03 03 06 03 03 -1 03 03 03 03 03 03 03 03 -1 -1 -1 -1 -1 03 03 03 03 03 -1 -1 03 03 03 03 03 03 03 03 03 03 03 03 03 03 -1 -1 -1 03 -1 -1 -1 03 03 03 03 03 03 03 03 03 03 03 07 06 07 03 03 03 03 03 03 03 03 03 03 -1 -1 -1 -1 -1 -1 07
07 -1 -1 -1 -1 -1 -1 -1 03 03 03 03 -1 -1 06 -1 -1 -1 03 -1 03 03 03 03 03 03 03 03 03 03 03 03 03 03 03 06 -1 -1 03 03 03 03 03 03 -1 -1 -1 06 -1 -1 03 06 03 03 03 03 03 03 03 03 03 03 03 03 03 03 03 03 03 -1 -1 03 03 -1 -1 -1 -1 06 -1 -1 -1 -1 -1 03 03 03 03 03 03 03 03 -1 -1 -1 -1 -1 03 03 03 03 03 03 03 03 03 -1 03 03 03 03 03 06 03 03 03 03 03 03 03 03 03 03 03 03 -1 -1 -1 -1 03 -1 -1 -1 -1 03 -1 -1 -1 -1 -1 03 03 -1 -1 -1 -1 03 03 07 06 07 03 -1 -1 03 03 03 03 03 03 -1 -1 -1 -1 -1 -1 03 03 03 03 -1 -1 -1 -1 03 03 03 03 03 03 03 03 03 03 03 06 -1 -1 03 03 03 03 -1 -1 06 03 03 03 03 03 03 03 03 03 07 06 03 06 07 03 03 03 03 03 03 03 03 -1 -1 -1 -1 -1 -1 -1 07
07 -1 -1 -1 -1 -1 -1 -1 03 03 03 03 -1 -1 -1 -1 -1 -1 -1 -1 03 03 03 03 03 03 03 03 03 03 03 03 03 03 03 -1 -1 -1 03 03 -1 -1 03 03 03 -1 -1 -1 -1 03 03 03 -1 -1 -1 03 03 03 03 03 03 03 03 03 03 03 03 03 -1 -1 03 03 03 03 03 -1 -1 -1 -1 -1 -1 -1 03 03 03 03 03 03 03 03 03 -1 -1 -1 -1 -1 03 03 03 03 03 03 03 03 -1 -1 -1 03 03 03 06 03 07 03 03 03 03 03 03 03 03 03 03 03 -1 -1 03 03 03 03 -1 -1 03 03 03 03 -1 -1 -1 -1 -1 -1 -1 03 03 03 06 03 03 06 03 -1 -1 -1 03 03 03 03 03 -1 -1 -1 -1 -1 -1 03 03 03 -1 -1 -1 -1 -1 -1 03 03 03 03 03 03 03 03 03 03 -1 -1 -1 03 03 03 03 -1 -1 -1 03 -1 -1 03 -1 03 03 03 07 06 06 03 06 06 07 03 03 03 03 03 03 03 -1 -1 -1 -1 -1 -1 -1 07
07 -1 -1 -1 -1 -1 -1 -1 -1 03 03 03 03 -1 -1 -1 -1 -1 -1 -1 -1 03 03 03 03 03 03 03 03 03 03 03 03 03 03 -1 -1 03 03 -1 -1 -1 -1 03 03 -1 -1 -1 -1 03 03 -1 -1 -1 -1 -1 06 03 03 03 03 03 03 03 03 03 03 -1 -1 -1 03 03 03 03 03 03 03 03 -1 -1 -1 -1 03 03 03 03 03 03 03 03 03 03 -1 -1 -1 -1 -1 03 03 03 03 03 -1 -1 -1 -1 -1 -1 03 06 03 03 06 07 03 03 03 03 03 03 03 03 -1 -1 -1 -1 03 03 03 03 -1 -1 03 03 03 03 03 03 -1 -1 -1 -1 03 03 03 03 07 03 03 06 07 03 -1 -1 -1 03 03 03 03 -1 -1 -1 -1 -1 -1 03 03 03 -1 -1 -1 -1 -1 -1 03 03 03 03 03 03 03 03 03 -1 -1 -1 03 03 03 03 03 03 -1 -1 -1 -1 -1 03 -1 -1 -1 07 03 06 03 03 03 06 03 03 03 03 03 03 03 -1 -1 -1 -1 -1 -1 -1 -1 07
07 -1 -1 -1 -1 -1 -1 -1 -1 03 03 03 03 -1 -1 -1 -1 -1 -1 -1 -1 03 03 03 03 03 03 03 03 03 03 03 03 03 -1 -1 -1 03 03 -1 -1 -1 -1 03 03 -1 -1 -1 -1 03 03 -1 -1 -1 -1 -1 -1 -1 -1 03 03 03 03 03 03 03 03 -1 -1 03 03 03 03 03 03 03 03 03 03 -1 -1 -1 03 03 03 03 03 03 03 03 03 03 03 -1 -1 -1 -1 -1 03 03 03 03 -1 -1 -1 -1 -1 -1 03 06 03 03 03 06 03 03 03 03 03 03 03 03 -1 -1 03 03 03 03 03 03 -1 -1 03 03 03 03 03 03 03 03 -1 -1 -1 03 03 03 06 03 03 03 06 06 03 -1 -1 03 03 03 -1 -1 -1 -1 -1 -1 -1 03 03 -1 -1 -1 -1 -1 -1 -1 -1 03 03 03 03 03 03 03 03 -1 -1 03 03 03 03 03 03 03 03 -1 -1 -1 -1 -1 -1 -1 -1 -1 03 06 03 03 03 06 03 03 03 03 03 03 03 -1 -1 -1 -1 -1 -1 -1 -1 07
07 07 07 07 07 07 07 07 07 04 04 04 04 06 -1 -1 -1 -1 06 -1 -1 -1 04 04 04 04 04 04 04 04 04 04 04 04 -1 -1 -1 04 06 -1 -1 -1 04 04 04 04 -1 -1 06 04 04 04 -1 -1 04 04 06 -1 -1 04 04 04 04 04 04 04 04 -1 -1 06 04 04 04 04 04 04 04 04 04 06 -1 -1 04 04 04 04 04 04 06 04 04 04 04 06 -1 -1 -1 06 04 04 04 04 04 04 04 04 -1 -1 -1 04 06 06 07 04 04 04 04 04 04 04 04 -1 -1 -1 04 04 06 04 04 04 -1 -1 04 04 04 06 04 04 04 04 -1 -1 -1 -1 04 04 04 07 07 07 06 04 04 -1 -1 -1 04 04 06 06 06 06 06 06 06 04 04 -1 -1 06 -1 -1 06 -1 -1 -1 04 04 04 04 04 04 -1 -1 -1 04 04 04 04 04 04 04 04 -1 04 04 -1 -1 06 -1 -1 06 07 07 07 07 07 04 04 04 04 04 04 04 04 07 07 07 07 07 07 07 07 07
