07 07 07 07 07 07 07 07 07 07 07 07 07 07 07 07 07 07 07 07 07 07 07 07 07 07 07 07 07 07 07 07 07 07 07 07 07 07 07 07 07 07 07 07 07 07 07 07 07 07 07 07 07 07 07 07 07 07 07 07 07 07 07 07 07 07 07 07 07 07 07 07 07 07 07 07 07 07 07 07 07 07 07 07 07 07 07 07 07 07 07 07 07 07 07 07 07 07 07 07 07 07 07 07
07 07 07 06 06 06 07 07 07 06 06 06 06 07 07 06 06 06 06 07 07 06 06 06 06 06 06 06 06 06 07 07 06 07 07 07 07 06 06 06 06 06 06 06 07 07 07 07 06 06 06 06 06 06 07 07 07 07 07 06 06 06 06 06 06 06 07 07 07 07 07 06 06 06 06 06 06 07 07 07 07 07 07 06 06 06 06 06 07 07 07 07 06 06 06 06 06 06 06 06 06 07 07 07
07 07 02 03 03 02 07 06 03 03 03 03 07 07 06 03 03 03 03 06 07 02 03 03 03 03 03 03 02 02 07 06 01 02 06 07 07 03 03 03 03 03 03 03 06 07 07 06 03 03 03 03 03 03 03 06 07 07 07 03 03 03 03 03 03 03 03 07 07 07 06 03 03 03 03 03 03 03 06 07 07 07 06 02 03 03 03 03 06 07 07 07 06 03 03 03 03 03 03 02 07 07 07 07
07 07 01 03 03 02 06 03 03 03 03 03 06 07 01 03 03 03 03 03 06 01 03 03 03 03 03 03 03 02 06 01 02 03 06 07 06 03 03 03 03 03 03 03 03 07 07 03 03 03 03 03 03 03 03 02 07 07 06 03 03 03 03 03 03 03 03 06 07 07 01 03 03 03 03 03 03 03 03 06 07 07 06 03 03 03 03 03 03 06 07 07 06 03 03 03 03 03 03 03 07 07 07 07
07 06 07 02 03 03 03 03 03 03 03 03 02 06 06 02 03 03 03 03 02 06 03 03 03 03 03 03 03 03 02 02 03 03 02 07 06 03 03 03 03 03 03 03 03 03 06 03 03 03 03 03 03 03 03 03 06 07 06 03 03 03 03 03 03 03 03 03 07 06 06 03 03 03 03 03 03 03 03 03 07 06 03 03 03 03 03 03 03 03 06 07 02 03 03 03 03 03 03 02 07 07 07 07
07 02 06 06 03 03 03 03 03 03 03 03 03 02 02 03 03 03 03 03 03 03 03 03 03 03 03 03 03 03 03 03 03 03 02 06 03 03 03 03 03 03 03 03 03 03 03 03 03 03 03 03 03 03 03 03 03 06 03 03 03 03 03 03 03 03 03 03 06 03 03 03 03 03 03 03 03 03 03 03 06 03 03 03 03 03 03 03 03 03 03 06 02 03 03 03 03 02 02 06 07 07 07 07
07 03 03 03 03 03 03 03 03 03 03 03 03 03 03 03 03 03 03 03 03 03 03 03 03 03 03 03 03 03 03 01 03 03 06 03 03 03 03 03 03 03 03 03 03 03 03 03 03 03 03 03 03 03 03 03 03 06 03 03 03 03 03 03 03 03 03 03 03 03 03 03 03 03 03 03 03 03 03 03 03 03 03 03 03 03 03 03 03 03 03 03 03 03 03 03 03 02 06 07 07 07 07 07
07 03 03 03 03 03 03 03 03 03 03 03 03 03 03 03 03 03 03 03 03 03 03 03 03 03 03 03 03 03 03 03 03 03 03 03 03 03 03 03 03 03 03 03 03 03 03 03 03 03 03 03 03 03 03 03 03 03 03 03 03 03 03 03 03 03 03 03 03 03 03 03 03 03 03 03 03 03 03 03 03 03 03 03 03 03 03 03 03 03 03 03 03 03 03 03 03 03 03 06 06 01 02 07
07 03 03 03 03 03 03 03 03 03 03 03 03 03 03 03 03 03 03 03 03 03 03 03 03 03 03 03 02 03 03 03 03 03 03 03 03 03 03 03 03 03 03 03 03 03 03 03 03 03 03 03 03 03 03 03 03 03 03 03 03 03 03 03 03 03 03 03 03 03 03 03 03 03 03 03 03 03 03 03 03 03 03 03 03 03 03 03 03 03 03 03 03 03 03 03 03 03 03 03 02 06 02 07
07 03 03 03 03 03 03 03 03 03 03 03 03 03 03 03 03 03 03 03 03 03 03 03 03 03 03 03 02 03 06 06 06 03 03 03 03 03 03 03 03 03 03 03 03 03 03 03 03 03 03 03 03 03 03 03 03 03 03 03 03 03 03 03 03 03 03 03 03 03 03 03 03 03 03 03 03 03 03 03 03 03 03 03 03 03 03 03 03 03 03 03 03 03 03 03 03 03 03 03 03 03 03 07
07 00 00 03 03 03 03 03 03 03 03 03 03 03 03 03 03 03 03 03 03 03 03 03 03 03 03 03 03 03 -1 -1 -1 03 03 03 03 03 03 03 03 03 03 03 03 03 03 03 03 02 02 03 03 03 03 03 03 03 03 03 03 03 03 03 03 03 03 03 03 03 03 03 03 03 03 03 03 03 03 03 03 03 01 03 03 03 03 03 03 03 03 03 03 03 03 03 03 03 03 03 03 00 00 07
07 00 00 00 00 03 03 03 03 03 03 03 03 03 03 03 03 03 03 03 03 03 03 03 03 03 03 03 03 -1 -1 -1 -1 03 03 03 03 03 03 03 03 03 03 03 03 03 03 03 02 03 03 03 03 03 03 03 03 03 03 03 03 03 03 03 03 03 03 03 03 03 03 03 03 03 03 03 03 02 02 -1 -1 03 02 02 -1 -1 03 03 03 03 03 03 03 03 03 03 03 03 03 00 00 00 00 07
07 00 00 00 00 00 03 03 03 03 03 03 03 03 03 03 03 03 03 03 03 03 03 03 03 03 03 03 03 -1 -1 -1 -1 03 03 03 03 03 03 03 03 03 03 03 03 03 03 03 03 03 03 03 03 03 07 07 03 03 03 03 03 03 03 03 03 03 03 03 03 03 03 03 03 03 03 03 02 -1 -1 -1 -1 -1 -1 -1 -1 -1 -1 -1 02 03 03 03 03 03 03 03 03 03 00 00 00 00 00 07
07 00 00 00 00 00 00 03 03 03 03 03 03 03 03 03 03 03 03 03 03 03 03 03 03 03 03 03 -1 -1 -1 -1 -1 03 03 03 03 03 03 03 03 03 03 03 03 03 03 03 03 03 03 03 03 06 06 02 07 03 03 03 03 03 03 03 03 03 03 03 03 03 03 03 03 03 03 03 -1 -1 -1 -1 -1 -1 -1 -1 -1 -1 -1 -1 02 03 03 03 03 03 03 03 03 00 00 00 00 00 00 07
07 00 00 00 00 00 00 03 03 03 03 03 03 03 03 03 03 03 03 03 03 03 03 03 03 03 03 03 -1 -1 -1 -1 -1 -1 03 03 02 03 03 03 03 03 03 03 03 03 03 03 -1 -1 03 03 03 06 06 03 06 03 03 03 03 03 03 03 03 03 03 03 03 03 03 03 03 03 03 03 -1 -1 -1 -1 03 03 03 03 03 -1 -1 -1 -1 03 03 03 03 03 03 03 03 00 00 00 00 00 00 07
07 00 00 00 00 00 00 00 03 03 03 03 03 03 03 03 03 03 03 03 03 03 03 03 03 03 03 -1 -1 -1 -1 -1 -1 -1 03 03 02 03 03 03 03 03 03 03 03 03 03 -1 -1 -1 -1 03 03 -1 06 02 07 -1 03 02 03 03 03 03 03 03 03 03 03 03 03 03 03 03 03 03 -1 -1 -1 03 -1 -1 03 -1 -1 03 -1 -1 -1 03 03 03 03 03 03 03 00 00 00 00 00 00 00 07
07 00 00 00 00 00 00 00 03 03 03 03 03 03 03 03 03 03 03 03 03 03 03 03 03 03 03 -1 -1 -1 -1 -1 -1 -1 -1 03 03 03 03 03 03 03 03 03 03 03 02 -1 -1 -1 -1 03 -1 -1 -1 06 -1 -1 -1 -1 03 03 03 03 03 03 03 03 03 03 03 03 03 03 03 03 -1 -1 -1 -1 -1 -1 03 -1 -1 -1 -1 -1 -1 03 03 03 03 03 03 03 00 00 00 00 00 00 00 07
07 00 00 00 00 00 00 00 00 03 03 03 03 03 03 03 03 03 03 03 03 03 03 03 03 03 -1 -1 -1 -1 -1 -1 -1 -1 -1 -1 03 03 03 03 03 03 03 03 03 03 02 -1 -1 -1 -1 03 -1 -1 -1 -1 -1 -1 -1 -1 -1 02 02 03 03 03 03 03 03 03 03 03 03 03 03 03 02 -1 -1 -1 -1 -1 03 -1 -1 -1 -1 -1 02 03 03 03 03 03 03 00 00 00 00 00 00 00 00 07
07 00 00 00 00 00 00 00 00 03 03 03 03 03 03 03 03 03 03 03 03 03 03 03 03 03 -1 -1 -1 -1 -1 -1 -1 -1 -1 -1 03 03 03 03 03 03 03 03 03 02 -1 -1 -1 -1 -1 -1 -1 -1 -1 -1 -1 -1 -1 -1 -1 -1 03 03 03 03 03 03 03 03 03 03 03 03 03 03 02 -1 -1 -1 -1 -1 01 -1 -1 -1 -1 -1 03 03 03 03 03 03 03 00 00 00 00 00 00 00 00 07
07 07 07 07 07 07 07 07 07 05 05 05 05 05 05 05 07 07 07 05 05 05 05 05 05 05 06 06 -1 -1 07 07 07 -1 -1 -1 06 05 05 05 05 05 05 06 05 05 05 05 05 05 06 -1 -1 -1 06 05 05 05 05 05 05 06 05 05 05 05 05 05 07 07 07 05 05 05 05 05 05 06 -1 -1 06 -1 05 -1 06 -1 -1 06 05 05 05 05 05 05 05 07 07 07 07 07 07 07 07 07
