6 6 6 6 6 6 6 6 6 6 6 6 6 6 6 6 6 6 6 6 6 6 6 6 6 6 6 6 6 6 6 6 6 6 6 6 6 6 6 6 6 6 6 6 6 6 6 6 6 6 6 6 6 6 6 6 6 6 6 6 6 6 6 6 6 6 6 6 6 6 6 6 6 6 6 6 6 6 6 6 6 6 6 6 6 6 6 6 6 6 6 6 6 6 6 6 6 6 6 6
3 5 5 5 6 6 5 5 6 6 6 5 5 5 3 3 5 5 6 5 5 5 6 5 5 5 3 5 5 5 6 6 5 3 6 5 5 6 6 3 5 6 5 3 5 6 6 5 5 3 5 6 6 5 3 3 5 5 6 6 5 3 5 6 6 6 6 5 5 5 6 6 5 5 5 6 5 5 3 3 5 5 6 5 5 3 5 5 6 6 5 5 6 6 6 5 6 6 6 6
3 3 5 3 5 5 3 3 5 6 5 3 5 3 3 3 3 3 5 3 5 3 5 5 3 3 3 3 3 5 6 5 3 3 5 3 3 5 5 3 3 5 3 2 3 5 5 3 3 3 5 6 6 5 3 3 3 5 6 5 3 3 0 5 6 6 5 3 3 3 5 6 6 5 5 6 5 3 3 3 3 3 6 5 3 3 3 5 6 5 3 5 6 6 5 3 5 6 5 6
0 3 3 3 3 3 3 3 5 6 5 3 3 3 3 3 3 3 5 3 3 3 3 3 3 3 3 3 3 3 5 3 3 3 3 3 3 3 3 3 3 3 1 3 1 5 3 3 3 3 3 5 6 5 3 3 3 3 5 3 3 3 0 5 6 5 3 3 3 3 3 5 5 3 3 5 3 3 3 3 3 3 5 3 3 3 3 3 5 3 3 3 6 6 5 3 3 5 5 6
0 3 3 3 3 3 3 3 3 5 3 3 3 3 3 3 3 3 3 3 3 3 3 3 3 3 3 3 3 3 3 3 3 3 3 3 3 3 3 3 3 2 3 0 5 5 3 3 3 3 3 3 5 3 3 3 3 3 3 3 3 3 0 5 6 5 3 3 3 3 3 3 3 3 3 5 3 3 3 3 3 5 5 3 3 3 3 3 3 3 3 3 5 5 3 3 3 3 5 6
0 3 3 3 3 3 3 3 3 3 3 3 3 3 3 3 3 3 3 3 3 3 3 3 3 3 2 3 2 3 3 3 3 3 3 3 3 3 3 3 3 3 1 5 5 3 3 3 3 3 3 3 3 3 3 3 3 3 3 3 3 3 0 0 5 3 3 3 3 3 3 3 3 3 3 3 3 3 3 3 3 3 3 3 3 3 3 3 3 3 3 3 3 3 3 3 3 3 5 6
0 3 3 3 3 3 3 3 3 3 3 3 3 3 3 3 3 3 3 3 3 3 3 3 3 2 3 1 3 2 3 3 3 3 3 3 3 3 3 3 3 3 2 3 3 3 3 3 3 3 3 3 3 3 3 3 3 3 3 3 3 3 0 0 5 3 3 3 3 3 3 3 3 3 3 3 3 3 3 3 2 3 3 2 3 3 3 3 3 3 3 3 3 3 3 3 3 3 5 6
0 0 3 3 3 3 3 3 3 3 3 3 3 3 3 3 3 3 3 3 3 3 3 3 3 3 1 0 1 3 3 3 3 3 3 3 3 3 3 3 3 3 3 3 3 3 3 3 3 3 3 3 3 3 3 3 3 3 3 3 3 3 0 0 0 0 3 3 3 3 3 3 3 3 3 3 3 3 1 5 5 3 1 3 3 3 3 3 3 3 3 3 3 3 3 3 3 3 5 6
0 0 3 3 3 3 3 3 3 3 3 3 3 3 3 3 3 3 3 3 3 3 3 3 3 2 3 1 3 2 3 3 3 3 3 3 3 3 3 3 3 3 3 3 3 3 3 3 3 3 3 3 3 3 3 3 3 3 3 3 3 3 0 0 0 0 3 3 3 3 3 3 3 3 3 3 3 1 5 5 6 5 1 2 3 3 3 3 3 3 3 3 3 3 3 3 3 3 5 6
0 0 3 3 3 3 3 3 3 3 3 3 3 3 3 3 3 3 3 3 3 3 3 3 3 3 2 3 2 3 3 3 3 3 3 3 3 3 3 3 3 3 3 3 3 3 3 3 3 3 3 3 3 3 3 3 3 3 3 3 3 3 0 0 0 0 3 3 3 3 3 3 3 3 3 3 3 5 6 0 0 6 5 3 2 3 3 3 3 3 3 3 3 3 3 3 3 3 5 6
0 0 0 3 3 3 3 3 3 3 3 3 3 3 3 3 3 3 3 3 3 3 3 3 3 3 3 3 3 3 3 3 3 3 3 3 3 3 3 3 3 3 3 3 3 3 3 3 3 3 3 3 3 3 3 3 3 3 3 3 3 3 0 0 0 0 0 3 3 3 3 3 3 3 3 3 3 5 5 0 0 6 5 2 2 3 3 3 3 3 3 3 0 3 3 3 3 5 5 6
0 0 0 0 0 3 3 3 3 3 3 3 3 3 3 3 3 3 3 3 3 3 3 3 3 3 3 3 3 3 3 3 3 3 3 3 3 3 3 3 3 3 3 3 3 3 3 3 3 3 3 3 3 3 3 3 3 3 3 3 3 3 0 0 0 0 0 3 3 3 3 3 3 3 3 3 2 1 5 5 6 5 1 3 3 3 3 3 3 3 3 3 0 3 3 3 5 5 5 6
0 0 0 0 0 0 3 3 3 3 3 3 3 3 3 3 3 3 3 3 3 3 3 3 3 3 3 3 3 3 3 3 3 3 3 3 3 3 3 3 3 3 3 3 3 3 3 3 3 3 3 3 3 3 3 3 3 3 3 3 3 0 0 0 0 0 0 3 3 3 3 3 3 3 3 3 2 3 3 5 5 5 3 2 3 3 3 3 3 3 3 0 0 3 3 3 3 3 5 5
0 0 0 0 0 0 0 3 3 3 3 3 3 3 3 3 3 3 3 3 3 3 3 3 3 3 3 3 3 3 3 3 3 3 3 3 3 3 3 3 3 3 3 3 3 3 3 3 3 3 3 3 3 3 3 3 3 3 3 3 3 0 0 0 0 0 0 3 3 3 3 3 3 3 3 3 3 3 2 1 3 1 2 3 3 3 3 3 3 3 3 0 0 3 3 3 3 3 3 3
0 0 0 0 0 0 0 3 3 3 3 3 3 3 3 3 3 3 3 3 3 3 3 3 3 3 3 3 3 3 3 3 3 3 3 3 3 3 3 3 3 3 3 3 3 3 3 3 3 3 3 3 3 3 3 3 3 3 3 3 3 0 0 0 0 0 0 0 3 3 3 3 3 3 3 3 3 3 3 3 3 3 3 3 3 3 3 3 3 3 0 0 0 0 3 3 3 3 3 3
5 5 5 5 5 5 5 5 5 5 5 5 4 4 4 4 4 4 4 4 4 4 4 5 5 5 5 5 5 5 4 4 4 4 4 4 4 4 4 4 4 4 4 5 5 5 5 4 4 4 4 4 4 4 4 4 4 4 5 5 5 0 0 5 0 5 0 0 0 5 5 4 4 4 4 4 4 4 4 4 4 4 4 4 4 4 4 4 4 0 0 0 0 0 0 5 5 5 5 5
6 6 6 6 6 6 6 6 6 6 4 4 4 4 4 4 4 4 4 4 4 4 4 4 6 6 6 6 6 4 4 4 4 4 4 4 4 4 4 4 4 4 6 6 6 6 6 6 4 4 4 4 4 4 4 4 4 4 6 6 0 0 0 6 0 6 0 0 0 6 6 5 4 4 4 4 4 4 4 4 4 4 4 4 4 4 4 4 0 0 0 0 0 0 6 6 6 6 6 6
6 6 6 6 6 6 6 6 6 4 4 4 4 4 4 4 4 4 4 4 4 4 4 4 4 6 6 6 6 4 4 4 4 4 4 4 4 4 4 4 6 6 6 6 6 6 6 4 4 4 4 4 4 4 4 4 4 6 6 6 0 0 0 6 0 6 0 0 0 6 6 6 4 4 4 4 4 4 4 4 4 4 4 4 4 4 4 4 0 0 0 0 0 0 6 6 6 6 6 6
